UUUUUUUUUBBBBBBBBBBBBBBBBUUUUUUUUU
BBBBBBBBBBBBBBBBBBBBBBBBBBBBBBBBBB
BBBBBBBBBBBBBBBBBBBBBBBBBBBBBBBBBB
UUUUUUUUUBBBBBBBBBBBBBBBBUUUUUUUUU
BBBBBBBBBBBBBBBBBBBBBBBBBBBBBBBBBB
BBBBBBBBBBBBBBBBBBBBBBBBBBBBBBBBBB
UUUUUUUUUUUUUUBBBBBBUUUUUUUUUUUUUU
BBBBBBBBBBBBBBBBBBBBBBBBBBBBBBBBBB
BBBBBBBBBBBBBBBBBBBBBBBBBBBBBBBBBB
UUUUUUUUUBBBBBBBBBBBBBBBBUUUUUUUUU
BBBBBBBBBBBBBBBBBBBBBBBBBBBBBBBBBB
BBBBBBBBBBBBBBBBBBBBBBBBBBBBBBBBBB
UUUUUUUUUBBBBBBBBBBBBBBBBUUUUUUUUU
BBBBBBBBBBBBBBBBBBBBBBBBBBBBBBBBBB
BBBBBBBBBBBBBBBBBBBBBBBBBBBBBBBBBB
BBBBBBBBBBBBBBBBBBBBBBBBBBBBBBBBBB
BBBBBBBBBBBBBBBBBBBBBBBBBBBBBBBBBB