NNNNNNNNNNNNNNNNNNNNNNNNNNNNNNNNNN
NNNNNNNNNNNNNNNNNNNNNNNNNNNNNNNNNN
NNNNNNNNNNNNNNNNNNNNNNNNNNNNNNNNNN
NNUBBBBBBBBBBBBBBBBBBBBBBBBBBBBUNN
NNUBBBBBBBBBBBBBBBBBBBBBBBBBBBBUNN
NNUBBBBBBBBBBBBBBBBBBBBBBBBBBBBUNN
NNUBBBBBBBBBBBBBBBBBBBBBBBBBBBBUNN
NNUBBBBBBBBBBBBBBBBBBBBBBBBBBBBUNN
NNUBBBBBBBBBBBBBBBBBBBBBBBBBBBBUNN
NNUBBBBBBBBBBBBBBBBBBBBBBBBBBBBUNN
NNUBBBBBBBBBBBBBBBBBBBBBBBBBBBBUNN
NNUBBBBBBBBBBBBBBBBBBBBBBBBBBBBUNN
NNUBBBBBBBBBBBBBBBBBBBBBBBBBBBBUNN
NNUBBBBBBBBBBBBBBBBBBBBBBBBBBBBUNN
NNUBBBBBBBBBBBBBBBBBBBBBBBBBBBBUNN
NNUBBBBBBBBBBBBBBBBBBBBBBBBBBBBUNN
NNUUUUUUUUUUUUUUUUUUUUUUUUUUUUUUNN